Z D D D D D D D D D D D D D D D D D D D D D D D D D D D D D D W
V G G G G G G G G G G G G G G G G G G G G G G G G G G G G G G V
V G G G G G G G G G G G G G G G G G G G G G G G G G G G G G G V
V G G G G G G G G G G G G G G G G G G G G G G G G G G G G G G V
V G G G G G G G G G G G G G G G G G G G G G G G G G G G G G G V
V G G G G G G G G G G G G G G G G G G G G G G G G G G G G G G V
V G G G G G G G G G G G G G G G G G G G G G G G G G G G G G G V
V G G G G G G G G G G G G G G G G G G G G G G G G G G G G G G V
V G G G G G G G G G G G G G G G G G G G G G G G G G G G G G G V
V G G G G G G G G G G G G G G G G G G G G G G G G G G G G G G V
V G G G G G G G G G G G G G G G G G G G G G G G G G G G G G G V
V G G G G G G G G G G G G G G G G G G G G G G G G G G G G G G V
V G G G G G G G G G G G G G G G G G G G G G G G G G G G G G G V
V G G G G G G G G G G G G G G G G G G G G G G G G G G G G G G V
V G G G G G G G G G G G G G G G G G G G G G G G G G G G G G G V
V G G G G G G G G G G G G G G G G G G G G G G G G G G G G G G V
V G G G G G G G G G G G G G G G G G G G G G G G G G G G G G G V
Y D D D D D D D D D D D D D D D D D D D D D D D D D D D D D D X
